11111111111111111111
10000000000000000001
10111000000000111001
10101000000000101001
10111000000000111001
10000000000000000001
10000000000000000001
10000000000000000001
10000110111111000001
10000100000000100001
10000110111111000001
1111111X111111111111