111111111111111111111111111111111111111111111111111111111111
100000000000000000000000000000000000000000000000000000000001
100000000000000000000000000000000000000000000000000000000001
100000000000000000000000000000000000000000000000000000000001
100111110000000000000000000000000000000111110000000000000001
100000010000000000000000000000000000000100000000000000000001
100000010000000000000000000000000000000100000000000000000001
100000010000000011111111111111111000000100000000000000000001
100000000000000010000000000000001000000000000000000000000001
100000000000000010000000000000001000000000000000000000000001
100000000000000010000000000000001000000000000000000000000001
100000000000000011111111111111111000000000000000000000000001
100000010000000000000000000000000000000100000000000000000001
100000010000000000000000000000000000000100000000000000000001
100111110000000000000000000000000000000111110000000000000001
100000000000000000000000000000000000000000000000000000000001
100000000000000000000000000000000000000000000000000000000001
100000000000000000000000000000000000000000000000000000000001
111111111111111111111111111111111111111111111111111111111111