11111111111111111111
10010000000000010001
10010000000000010001
10000001111000000001
10000000000000000001
10000000000000000001
10000000000000000001
10000000000000000001
10000000000000000001
10000001111000000001
10010000000000010001
1111111X111111111111