11111111111111111111
10000000000000000001
10000001110000000001
10000001110000000001
10000000000000000001
10000000000000000001
10000000000000X000001
10000000000000000001
10000000000000000001
10000000000000000001
10000000000000000001
11111111111111111111
