11111111111111111111
10000011110000000001
10000010010000000001
10000000000000000001
10000000000000000001
11100000000000011111
10000000000000000001
11100000000000011111
10000000000000000001
10000010010000000001
10000010110000000001
1111111X111111111111